1111111111111111111111111111111111
1P0000000000000C00000C000100000001
1110010100100000C01001001E00010101
100000000C00C0000000000000000000C1
1111111111111111111111111111111111